source: SRC:CLR: Engineering at SourceClear
Quora: Engineering at Quora
Yelp: Yelp Product & Engineering Blog
Twitter: Twitter Engineering
Facebook: Facebook Engineering
Yammer: Blog - Yammer Engineering
Etsy: Code as Craft
FourSquare: Foursquare Engineering Blog
AirBnB: Airbnb Engineering
WebEngage: WebEngage Engineering Blog
LinkedIn: Blog | LinkedIn Engineering
NetFlix: The Netflix Tech Blog
BankSimple: Simple Blog
Square: The Corner
SoundCloud: SoundCloud Backstage and API Blog - SoundCloud Developers
Flickr: code.flickr.com
Dropbox: Dropbox Tech Blog
Instagram: Instagram Engineering
Cloudera: Blog | Apache Hadoop for the Enterprise | Cloudera
BandCamp: Bandcamp Tech
Oyster: Insights from Oyster.com's Tech Team
SlideShare: Behind the scenes look at the technology, team and ideas that drive SlideShare!
SmugMug: SmugMug's Don MacAskill
Reddit: blog.reddit -- what's new on reddit
Github: The GitHub Blog: Engineering
Pinterest: Making Pinterest
FiftyThree: Making FiftyThree
LiveChat: Developers Blog
Heroku: http://engineering.heroku.com
Trello (Fog Creek): Helping the world's best developers make better software
&yet: &yet Blog
